1111111111111111111111111111111111
1E000000T000000C00000C000000000001
1010010100100000101001000000010101
1010010010101010001001000T00010101
1P0000000C00C00000000000T0000000C1
1010010100100000101001000000010101
1010010010101010001001000000010101
10000T000C00C00000000000T0000000C1
1111111111111111111111111111111111