111111111111111111111
100100000111001100C11
10000111000000C000001
1P0011E00C01110000001
111111111111111111111